1111111111111111111111111111111111
1E0000000M0000C00000C0000000000001
11101010001000001010010M0000010101
1010010010101010001001000000010111
1P00000M0C000C000000000000000000C1
1111111111111111111111111111111111
