11111111111111111
1C0000000000000E1
10111011111111111
101M1000000010001
10000011101111001
10001000000000101
11111000111011101
10000010000000001
10111111011111101
100000000000P0001
11111111111111111
