1111111111111111111
1C000C0000C000C00E1
1011101111111111111
101M100000001000101
1000001110111101001
100010C000000010001
1111100011101111001
100000C000000000001
1011111101111111001
1000C00000P00000001
1111111111111111111
