11111111111
1C0000000E1
10111011111
101M1000001
10000011101
10001000001
11111000101
10000010001
10111111001
100000000P1
11111111111
