111111111
2ECX00P01
111111111
