111111111
10EC00P01
111111111
